11111111111111111111
1P00000C00000C000001
111111111111111111C1
1C00000C00000C000001
10111111111111111111
1000C00000C00000C0E1
11111111111111111111