11111111111111111111
1P000000000000000001
10000000000000000001
10000000000000000001
10000000000000000001
10000011111100000001
10000010000100000001
10000010000100000001
10000010000100000001
10000010000100000001
10000010000100000001
10000010000100000001
10000010000100000001
10000010000100000001
10000010000100000001
10000011111100000001
100000000E00000000C1
11111111111111111111
