11111111111111111111
1P000000000C00000C01
11111111111011111111
11111100000000000011
11000000000000000011
1000C001111111111111
10000111111111111111
10C0C111111111111111
100000000000000000E1
11111111111111111111