1111111111111111111111111111111111
1E1000000000000C00000C0000000010C1
1010010101000001010010000000101011
1010X10010101010001001000X00010001
1P0000000C00C1000000000000000000C1
1111111111111111111111111111111111