111111111111
1P000C000011
111011110011
1C0001000C11
111111110001
100000111011
101100100011
1C0101110001
100000000011
1111111000E1
111111111111