1111111111
1P00010C01
1011011101
1011000101
10C0011101
1110100C01
1010111101
1000000001
11111111E1
1111111111
