1111111111111111111111111
11111111C1111111111111111
1000000001111111111111111
1011111100000000000000001
1011111111111111111111101
100000000C000000111111101
1111111111111110111110001
1000000000000C0011111C111
10111111111P1111111110001
1011111111111111111111101
100C000000001000000000001
1111111111111111111111101
1000000000000000000000001
1011111111111111111111111
101100000000C000000000001
10000111111111111111111E1
1111111111111111111111111