11111
100P1
100C1
100E1
11111