1111111111111111111111111
1P1000C01C0C0CC1C100C1CC1
1C1C11101011110101C100101
1000100010101101011101001
1111101110100001000000001
1C000C1000101111011111101
101111101110100001C00C101
10000000100C1011111101101
1111111110111010001000001
100C000000100010101111101
101111111C10111010000C1C1
1010000011101000111111101
1011011000001C10000000001
1000011001111011111111111
1111111110000010000000101
1CC1000100111110010010001
1CC00100000000001C01001E1
1111111111111111111111111